###########
#   #     #
# ### ### #
#   # #   #
# # # # # #
# #   # # #
####### ###
#   # #   #
# # # ### #
# #   #   #
# ##### # #
#       # #
###########
